ACC - Licenciatura em Animação Cultural e Comunitária
ARQ - Licenciatura em Arquitectura Paisagista
BEG - Licenciatura em Bioengenharia
BIO - Licenciatura em Biologia
GEO - Licenciatura em Biologia e Geologia
BQU - Licenciatura em Bioquímica
CCO - Licenciatura em Ciências da Comunicação
CNT - Licenciatura em Ciências da Nutrição
CDA - Licenciatura em Ciências do Ambiente
LCD - Licenciatura em Ciências do Desporto
CMU - Licenciatura em Comunicação e Multimédia
ECN - Licenciatura em Economia
EDB - Licenciatura em Educação Básica
ENF - Licenciatura em Enfermagem
EAG - Licenciatura em Engenharia Agronómica
EBM - Licenciatura em Engenharia Biomédica
CIVB - Licenciatura em Engenharia Civil
MESINTEGI - Mestrado Integrado em Engenharia e Gestão Industrial
MESINTEEC - Mestrado Integrado em Engenharia Eletrotécnica e de Computadores
FLO - Licenciatura em Engenharia Florestal
EINF - Licenciatura em Engenharia Informática
EME - Licenciatura em Engenharia Mecânica
EZOO - Licenciatura em Engenharia Zootécnica
ENO - Licenciatura em Enologia
GEB - Licenciatura em Genética e Biotecnologia
GES - Licenciatura em Gestão
LRE - Licenciatura em Línguas e Relações Empresariais
LLC - Licenciatura em Línguas, Literaturas e Culturas
LMV - Mestrado Integrado em Medicina Veterinária
PSI - Licenciatura em Psicologia
RPM - Licenciatura em Reabilitação Psicomotora
LSS - Licenciatura em Serviço Social
TAP - Licenciatura em Teatro e Artes Performativas
LTUR - Licenciatura em Turismo
TIC - Licenciatura em Tecnologias da Informação e Comunicação
EGI - Licenciatura em Engenharia e Gestão Industrial